111111111
101000101
1E100C101
100P00101
111111111
