1111111111111
1001000000001
100E011111001
1P0C110000001
1111111111111
