11P11E101C111
1001000000P01
1000011111001
1P0011E0000C1
1111111111111
