1111111111111111111111111111111111
1E00000000000000000000100000000001
1010010100100000111001000000010101
1111011111111111001111111000010101
1000000000000000001000001000000001
1000000000000000001000001000000001
1000000000000000000000001000000001
1000000000000000001000000000000001
1000000000000000001000001000000001
1000000000010000001000001000000001
10000000000000000010000000C0000001
1000000000000000000000000000000001
1000000000000000000000000P00000001
1000000000000000000000000000000001
1111111111111111111111111111111111
