111111111111111111111
100000000000000000001
101000111001000010101
111101100111111001101
100000001000000000001
100000001000001000001
1000000000000010P0001
100000001000001000001
100000001000001000001
10000C001000000000001
100000000000E00000001
111111111111111111111
