1111111111111111111111111111111
1000000000000000000000000000001
10100101001C0000111001C00010101
1111111111111011001111110010101
100000000C000000001000000000001
100000000000000C001000001000001
1000000000000000000000001000001
1000000000000P0C00100C001000001
1000000000000000001000001000001
1000000000E00000001000000000001
100000000000000C000000000000001
1111111111111111111111111111111
