1111111111
100C00P001
100E000011
1111111111